11111111111111111
1P000010000C00001
10000010000000001
10000011000000E01
1000EC00000000001
11111111111111111
