11111111111111111
1P100010000000001
10000010000000011
10000C11000000001
1E000000000000001
11111111111111111
